2,2,2,2,2,2,2,2,2,2,2,2,2,2,2,2,2,2,2,2,2,2,2,2,2,2,2,2,2,2
2,2,2,2,2,2,2,2,2,2,2,2,2,2,2,2,2,2,2,2,2,2,2,2,2,2,2,2,2,2
2,2,2,2,2,2,2,2,2,2,2,2,2,2,2,2,2,2,2,2,2,2,2,2,2,2,2,2,2,2
2,2,2,2,2,2,2,2,2,2,2,2,2,2,2,2,2,2,2,2,2,2,2,2,2,2,2,2,2,2
2,2,2,2,2,2,2,2,2,4,4,4,4,4,4,4,4,4,4,4,2,2,2,2,2,2,2,2,2,2
2,2,2,2,2,2,2,2,2,4,3,3,1,1,0,1,1,3,3,4,2,2,2,2,2,2,2,2,2,2
2,2,2,2,2,2,2,2,2,4,3,3,1,0,1,0,1,3,3,4,2,2,2,2,2,2,2,2,2,2
2,2,2,2,2,2,2,2,2,4,1,1,3,1,0,1,3,1,1,4,2,2,2,2,2,2,2,2,2,2
2,2,2,2,2,2,2,2,2,4,1,0,1,1,0,1,1,0,1,4,2,2,2,2,2,2,2,2,2,2
2,2,2,2,2,2,2,2,2,4,0,1,0,0,1,0,0,1,0,4,2,2,2,2,2,2,2,2,2,2
2,2,2,2,2,2,2,2,2,4,1,0,1,1,0,1,1,0,1,4,2,2,2,2,2,2,2,2,2,2
2,2,2,2,2,2,2,2,2,4,1,1,3,1,0,1,3,1,1,4,2,2,2,2,2,2,2,2,2,2
2,2,2,2,2,2,2,2,2,4,3,3,1,0,1,0,1,3,3,4,2,2,2,2,2,2,2,2,2,2
2,2,2,2,2,2,2,2,2,4,3,3,1,1,0,1,1,3,3,4,2,2,2,2,2,2,2,2,2,2
2,2,2,2,2,2,2,2,2,4,4,4,4,4,4,4,4,4,4,4,2,2,2,2,2,2,2,2,2,2
2,2,2,2,2,2,2,2,2,2,2,2,2,2,2,2,2,2,2,2,2,2,2,2,2,2,2,2,2,2
2,2,2,2,2,2,2,2,2,2,2,2,2,2,2,2,2,2,2,2,2,2,2,2,2,2,2,2,2,2
2,2,2,2,2,2,2,2,2,2,2,2,2,2,2,2,2,2,2,2,2,2,2,2,2,2,2,2,2,2
2,2,2,2,2,2,2,2,2,2,2,2,2,2,2,2,2,2,2,2,2,2,2,2,2,2,2,2,2,2
2,2,2,2,2,2,2,2,2,2,2,2,2,2,2,2,2,2,2,2,2,2,2,2,2,2,2,2,2,2
8-13
0,Crate.col.png
1,Floor..png
2,Grass..png
3,Plate..png
4,Wall.col.png
