2,2,2,2,2,2,2,2,2,2,2,2,2,2,2,2,2,2,2,2,2,2,2,2,2,2,2,2,2,2
2,2,2,2,2,2,2,2,2,2,2,2,2,2,2,2,2,2,2,2,2,2,2,2,2,2,2,2,2,2
2,2,2,2,2,2,2,2,2,2,2,2,2,2,2,2,2,2,2,2,2,2,2,2,2,2,2,2,2,2
2,2,2,2,2,2,2,2,2,2,2,2,2,2,2,2,2,2,2,2,2,2,2,2,2,2,2,2,2,2
2,2,2,2,2,2,2,2,2,2,4,4,4,2,2,2,4,4,4,2,2,2,2,2,2,2,2,2,2,2
2,2,2,2,2,2,2,2,2,4,4,3,4,4,2,4,4,3,4,4,2,2,2,2,2,2,2,2,2,2
2,2,2,2,2,2,2,2,4,4,1,0,1,4,4,4,1,0,1,4,4,2,2,2,2,2,2,2,2,2
2,2,2,2,2,2,2,4,4,3,0,1,0,3,4,3,0,1,0,3,4,4,2,2,2,2,2,2,2,2
2,2,2,2,2,2,2,4,3,0,1,1,1,1,1,0,1,3,1,0,3,4,2,2,2,2,2,2,2,2
2,2,2,2,2,2,2,4,4,3,0,1,0,3,4,3,0,1,0,3,4,4,2,2,2,2,2,2,2,2
2,2,2,2,2,2,2,2,4,4,1,0,1,4,4,4,1,0,1,4,4,2,2,2,2,2,2,2,2,2
2,2,2,2,2,2,2,2,2,4,4,3,4,4,2,4,4,3,4,4,2,2,2,2,2,2,2,2,2,2
2,2,2,2,2,2,2,2,2,2,4,4,4,2,2,2,4,4,4,2,2,2,2,2,2,2,2,2,2,2
2,2,2,2,2,2,2,2,2,2,2,2,2,2,2,2,2,2,2,2,2,2,2,2,2,2,2,2,2,2
2,2,2,2,2,2,2,2,2,2,2,2,2,2,2,2,2,2,2,2,2,2,2,2,2,2,2,2,2,2
2,2,2,2,2,2,2,2,2,2,2,2,2,2,2,2,2,2,2,2,2,2,2,2,2,2,2,2,2,2
2,2,2,2,2,2,2,2,2,2,2,2,2,2,2,2,2,2,2,2,2,2,2,2,2,2,2,2,2,2
2,2,2,2,2,2,2,2,2,2,2,2,2,2,2,2,2,2,2,2,2,2,2,2,2,2,2,2,2,2
2,2,2,2,2,2,2,2,2,2,2,2,2,2,2,2,2,2,2,2,2,2,2,2,2,2,2,2,2,2
2,2,2,2,2,2,2,2,2,2,2,2,2,2,2,2,2,2,2,2,2,2,2,2,2,2,2,2,2,2
8-16
0,Crate.col.png
1,Floor..png
2,Grass..png
3,Plate..png
4,Wall.col.png
5,ZCratePlate.col.png
57:60000