2,2,2,2,2,2,2,2,2,4,4,2,4,4,4,2,2,2,2,2,2,2,2,2,2,2,2,2,2,2
2,2,2,2,2,2,2,2,2,2,2,4,4,2,4,2,2,2,2,2,2,2,2,2,2,2,2,2,2,2
2,2,2,2,2,2,2,2,2,2,4,4,4,4,4,2,2,2,2,2,2,2,2,2,2,2,2,2,2,2
2,2,2,2,2,1,2,2,4,4,4,4,4,2,4,2,2,2,2,2,2,2,2,2,2,2,2,2,2,2
2,2,2,2,1,2,2,2,2,2,2,2,2,4,2,4,2,4,2,2,2,2,2,2,2,2,2,2,2,2
2,2,2,2,1,2,2,2,4,2,2,2,4,2,4,4,4,4,4,4,4,2,2,2,2,2,2,2,2,2
2,2,2,2,1,2,2,2,4,2,2,2,4,2,2,2,2,2,2,4,2,2,2,2,2,2,2,2,2,2
2,2,2,2,1,2,2,2,4,2,2,2,2,4,2,2,2,4,2,2,2,2,2,2,2,2,2,2,2,2
2,2,2,2,2,1,2,2,4,2,2,2,2,2,2,4,4,4,2,2,2,2,2,2,2,2,2,2,2,2
2,2,2,2,2,2,1,1,1,4,2,2,2,4,4,2,2,2,2,4,2,2,2,2,2,2,2,2,2,2
2,2,2,2,2,2,2,2,1,1,4,4,4,2,2,4,2,2,4,2,2,4,2,2,2,2,2,2,2,2
2,2,2,2,2,2,2,2,1,4,4,2,4,2,4,2,2,4,2,2,4,4,4,4,2,2,2,2,2,2
2,2,2,2,2,2,2,1,2,4,4,2,4,2,2,4,2,2,2,2,2,4,2,2,2,2,2,2,2,2
2,2,2,2,2,2,1,2,2,2,4,2,2,2,2,2,2,4,2,4,4,2,4,2,2,2,2,2,2,2
2,2,2,2,2,1,1,2,2,4,4,2,4,2,2,4,2,4,2,2,4,2,4,2,2,2,2,2,2,2
2,2,2,2,2,1,2,2,4,4,2,4,2,4,2,4,2,2,2,2,2,2,2,2,2,2,2,2,2,2
2,2,2,2,2,1,1,2,2,2,4,2,4,2,2,2,2,4,2,2,2,2,2,2,2,2,2,2,2,2
2,2,2,2,2,2,2,2,2,2,2,4,2,4,4,4,4,4,4,4,2,2,2,2,2,2,2,2,2,2
2,2,2,2,2,2,2,2,2,2,2,2,2,2,2,2,2,2,4,2,4,2,2,2,2,2,2,2,2,2
2,2,2,2,2,2,2,2,2,2,2,2,2,2,2,2,2,2,2,2,2,2,4,4,4,2,2,2,2,2
1-4
0,Crate.col.png
1,Floor..png
2,Grass..png
3,Plate..png
4,Wall.col.png
